abstract final class UserText {

  //home screen
  static const homeNavBarHome = 'Home';
  static const homeNavBarRecords = 'Records';
  static const homeNavBarSettings = 'Settings';
  static const homeTabBarPurse = 'Purse';
  static const homeTabBarPortfoilo = 'Portfolio';
  static const homeTabPocketMoney = 'POCKET MONEY';
  static const homeTabNetWorth = 'NET WORTH';
  static const accountName = 'Account Name';
  static const addNewAccount = 'Add New Account';
  static const addAnAccount = 'Add Account';
  static const editAnAccount = 'Edit Account';
  static const newRecord = 'New Record';
  static const noAccountsFound = '''
No Accounts Found.
Use the '+' button to create a new account.''';

  //settings screen
  static const makeThemeBackgroundBlack = 'Make Background Black';
  static const makeThemeBackgroundWhite = 'Make Background White';
  static const selectTheme = 'Select Theme';
  static const theme = 'Theme';
  static const light = 'Light';
  static const dark = 'Dark';
  static const defaultCurrency = 'Default Currency';
  static const manageCurrencies = 'Manage Currencies';
  static const manageTags = 'Manage Tags';
  static const manageCategories = 'Manage Categories';

  //general
  static const appName = 'Kashflow';
  static const delete = 'Delete';
  static const save = 'Save';
  static const done = 'Done';
  static const cancel = 'Cancel';
  static const system = 'System';
  static const search = 'Search';
  static const otherCurriences = 'Other Currencies';
  static const savedCurriences = 'Saved Currencies';
  static const currency = 'Currency';
  static const amount = 'Amount';
  static const description = 'Description';
  static const selectCurrency = 'Select Currency';
  static const selectIcon = 'Select Icon';
  static const selectColor = 'Select Color';
  static const changeIcon = 'Change Icon';
  static const resetColors = 'Reset Colors';
  static const changeIconColor = 'Change Icon Color';
  static const changeBackgroundColor = 'Change Background Color';
  static const shade = 'Shade';
  static const recent = 'Recent';
  static const nothingFound = 'Noting Found';
  static const underConstruction = '''
Sorry, this feature is still under construction ðŸš§ðŸš§ðŸš§.
Check back again after the app has been updated.''';
  static const edit = 'Edit';
  static const dismiss = 'Dismiss';
  static const expenseCategories = 'Expense Categories';
  static const incomeCategories = 'Income Categories';
  static const recommended = 'Recommended';
  static const blackAndWhite = 'Black & White';
  static const any = 'Any';

  //error messages
  static const accountExistErrorMsg =
      'An account with this name already exists.';
  static const cannotBeEmpty = 'Cannot be empty';
  static const tooShort = 'Too short';
}
